6 HISPERICA FAMINA

Cibonea : pliadum non exhomicant fulgora·

Merseum solifluus : eruit neuum †tractus (tactus)·

140 Densos phetoneum : extricat sudos incendium-
Roscida : aret rubigine stillicidia·

Nec oliuatus frondea : oliuat nimbus robora·
Fenosas : diuiduat imber uuas·
Micras uricomus : apricat lacunas rogus

145 mundanum : que torret iubar girum·

Aligera placoreum : reboat curia concentum·
Tinulas patulis : mormurant armonias rostris·
Concauos : aurium refoculant mulcedine cliuos·
Frondicomas auitica : orbat latebras turma·

150 Capaneas : aculeant gleuas·

Uermia : sorbellant picis frusta·

Oleda : pungunt stercolinia·

sameas esciferis : replent uesiculas ⁹⁶sucis.
Pecoreus uasta : lustrat coetus pascua·

155 Calastreas : meant calcibus pessas·

Campanea uariis : serunt predia conciliis·
Interna glaucis : saturant exta serpellis·
Holerosa z sennosis motibus ruminant pabula·
Insontes : diuiduant ouilia ides·

160 †arboreas pontes pedestri tramite tranant
Fenosos lanigerae : intrant †agnos (agros) caterue
Herbosas : carpunt dentibus uuas·

Hirsutus : suum deseruit gurgitia coetus·
Terrestres : suffodiunt rostris sablones

165 Stabiles z filicum sorbent radices·

Holerosum : que gustant sucum·

[fol. 4

Tabulosa ε flagrantes essuum orbant sonipedes stabula·

Atritas : frangosis motibus meant arrigas·
Ferreos ε que soluunt sessores cruribus sigellos·
170 Concauos : sennosis motibus replent toraces·
Amens : ferine prolis cohors
almos : calcat epimnos·

158 pabula gl. uel p (over the b).

